1111111111111
10010000001C1
1000011111111
1P0000E000001
1111111111111