111111111111111111111111111111111111111111111111111111
100000000000000000000000000000000000000000000000000001
100000000000000000000000000000000000000000000000000001
100000000000000000000000000000000000000000000000000001
100000000000000000000000000000000000000000000000000001
100000000000000000000000000000000000000000000000000001
100000000000000000000000000000000000000000000000000001
100000000011111000010000111110000100000000000000000001
100000000010000000101000100000001010000000000000000001
100000000010000001111100100000011111000000000000000001
100000000011111010000010111110100000100000000000000001
100000000000000000000000000000000000000000000000000001
100000000000000000000000000000000000000000000000000001
100000000000000000000000000000000000000000000000000001
100000000000000000000000000000000000000000000000000001
100000000000000000000000001100000000000000000000000001
100000000000000000000000000000000000000000000000000001
100000000000000000000000000000000000000000000000000001
100000000000000000000000000000000000000000000000000001
100000000000000000000000000000000000000000000000000001
100000000000000000000000001100000000000000000000000001
100000000000000000000000000000000000000000000000000001
100000000000000000000000000000000000000000000000000001
100000000000000000000000000000000000000000000000000001
100000000000000000000000000000000000000000000000000001
100000000000000000000000000000000000000000000000000001
100000000000000000000000000000000000000000000000000001
100000000000000000000000001100000000000000000000000001
100000000000000000000000001100000000000000000000000001
100000000000000000000000001100000000000000000000000001
100000000000000000000000001100000000000000000000000001
100000000000000000000000001100000000000000000000000001
100000000000000000000000001100000000000000000000000001
100000000000000000000000001100000000000000000000000001
10000000E000000000000000001100000000000000000000000001
100000000000000000000000001100000000000000000000000001
1000000P00C0000000000000001100000000000000000000000001
100000000000000000000000001100000000000000000000000001
111111111111111111111111111111111111111111111111111111