111111
10NC01
1P0CE1
10N001
111111