1111111111111111111111111111111111
1E000C000000000C00000C0000N0000001
1N100101N0100000101001000000010101
101001001010101N001N01000000010101
1P0000000C00C00000000000000N0000C1
1111111111111111111111111111111111