1111111111111111111111111111111111111111
1000000000000000000000000000000000000001
1000001111100001000011111000010000000001
1000001000000010100010000000101000000001
1000001000000111110010000001111100000001
1000001111101000001011111010000010000001
1000000000000000000000000000000000000001
1000000000000000000000110000000000000001
1000000000000000000000000000000000000001
1000000000000000000000NN0000000000000001
1000000000000000000000000000000000000001
100000000000NNNNNNNNNNNNNNNNNNNNN0000001
1000000000001E100000N0110000000000000001
1001001000000000000000110000000000000001
101P10C100000000000000110000000000000001
1000001000000000000000110000000000000001
1000000000000000000000110000000000000001
1000000000000000000000110000000000000001
1000000000000000000000110000000000000001
1000000000000000000000110000000000000001
1000000000000000000000110000000000000001
1111111111111111111111111111111111111111